%%%%%%%%%%%%%%%%%%
%.______________.%
%________________%
%____________G___%
%________________%
%________________%
%________________%
%________________%
%________________%
%________________%
%________________%
%________________%
%________________%
%________________%
%________________%
%________________%
%P______________.%
%%%%%%%%%%%%%%%%%%
