%%%%%%%%%%%%%%%%%%
%.______________.%
%______%______.__%
%__%__%%%%_%_G___%
%__%_G___%_%__.__%
%_%%_____%_%_%%%%%
%________%_%___%_%
%%%%%%_____%_____%
%_...%________%%_%
%_%%%%_.____%____%
%___%_____%_%_.__%
%%%_________%_%%%%
%_________%_%_%__%
%%%%%_%%__%___%__%
%______%__%.__%__%
%__%.__%_%%%%_%__%
%P_%___%________.%
%%%%%%%%%%%%%%%%%%
