%%%%%%%%%%%%%%%%%%
%____________G___%
%%%%%%%%%%%%%%%%%%
%P______________.%
%%%%%%%%%%%%%%%%%%
