%%%%%%
% . .%
%. . %
% . .%
%. . %
% .  %
%  . %
%   .%
%P . %
%%%%%%
